Serpentine Challenge
1,1,1,1,1,1,1,1,1,1,1,1,1,1,1,1
1,0,0,0,1,0,0,0,1,0,0,0,1,0,0,1
1,1,1,0,1,1,1,0,1,1,1,0,1,1,0,1
1,0,0,0,0,0,1,0,0,0,1,0,0,1,0,1
1,0,1,1,1,0,1,1,1,0,1,1,0,1,0,1
1,0,0,0,1,0,0,0,1,0,0,0,0,1,0,1
1,1,1,0,1,1,1,0,1,1,1,1,0,1,0,1
1,0,0,0,0,0,1,0,0,0,0,1,2,0,0,1
1,0,1,1,1,0,1,1,1,1,0,1,1,1,0,1
1,0,0,0,1,0,0,0,0,1,0,0,0,1,0,1
1,1,1,0,1,1,1,1,0,1,1,1,0,1,0,1
1,0,0,0,0,0,0,1,0,0,0,1,0,1,0,1
1,0,1,1,1,1,0,1,1,1,0,1,0,1,0,1
1,0,0,0,0,1,0,0,0,1,0,0,0,0,0,1
1,1,1,1,0,1,1,1,0,1,1,1,1,1,0,1
1,1,1,1,1,1,1,1,1,1,1,1,1,1,3,1

Treacherous Maze
1,1,1,1,1,1,1,1,1,1,1,1,1,1,1,1
1,0,0,0,1,0,0,0,1,0,0,0,1,0,0,1
1,1,1,0,1,1,1,0,1,1,1,0,1,1,0,1
1,0,0,0,0,0,1,0,0,0,1,0,0,1,0,1
1,0,1,1,1,0,1,1,1,0,1,1,0,1,0,1
1,0,0,0,1,0,0,0,1,0,0,0,0,1,0,1
1,1,1,0,1,1,1,0,1,1,1,1,0,1,0,1
1,0,0,0,0,0,1,0,0,0,0,1,0,0,0,1
1,0,1,1,1,0,1,1,1,1,0,1,1,1,0,1
1,0,0,0,1,0,0,0,0,1,0,0,0,1,0,1
1,1,1,0,1,1,1,1,0,1,1,1,0,1,0,1
1,0,0,0,0,0,0,1,0,0,0,1,0,0,0,1
1,0,1,1,1,1,0,1,1,1,0,1,1,1,0,1
1,0,0,0,0,1,0,0,0,0,0,0,0,1,2,1
1,1,1,1,0,1,1,1,1,1,1,1,0,1,0,1
1,1,1,1,1,1,1,1,1,1,1,1,1,1,3,1

Perilous Journey
1,1,1,1,1,1,1,1,1,1,1,1,1,1,1,1
1,0,0,0,1,0,0,0,1,0,0,0,1,0,0,1
1,1,1,0,1,1,1,0,1,1,1,0,1,1,0,1
1,0,0,0,0,0,1,0,0,0,1,0,0,1,0,1
1,0,1,1,1,0,1,1,1,0,1,1,0,1,0,1
1,0,0,0,1,0,0,0,1,0,0,0,0,1,0,1
1,1,1,0,1,1,1,0,1,1,1,1,0,1,0,1
1,0,0,0,0,0,1,0,0,0,0,1,0,0,0,1
1,0,1,1,1,0,1,1,1,1,0,1,1,1,0,1
1,0,0,0,1,0,0,0,0,1,0,0,0,1,0,1
1,1,1,0,1,1,1,1,0,1,1,1,0,1,0,1
1,0,0,0,0,0,0,1,0,0,0,1,0,1,0,1
1,0,1,1,1,1,0,1,1,1,0,1,0,1,0,1
1,0,0,0,0,1,0,0,0,0,0,0,0,0,2,1
1,1,1,1,0,1,1,1,1,1,1,1,1,1,0,1
1,1,1,1,1,1,1,1,1,1,1,1,1,1,3,1

